//1,2,3,4,5,6,7,8,9,10,11,12,13,14,15,16,17,18,19,20,21,22,23,24,25,26,27,28,29,30,31,32
0,0,0,0,0,0,0,0,0,0,0,0,0,0,0,0,0,0,1,1,1,1,1,1,1,1,1,1,1,1,1,1
0,0,0,0,0,0,0,0,0,0,0,0,0,0,0,0,0,0,1,0,0,0,0,0,0,0,0,0,0,0,0,3
0,0,0,0,0,0,0,0,0,0,0,0,0,0,0,0,0,0,1,0,0,0,0,0,0,0,0,0,0,0,0,3
0,0,0,0,0,0,0,0,0,0,0,0,0,0,0,0,0,0,1,0,0,0,0,0,0,0,0,0,0,0,0,3
0,0,0,0,0,0,0,0,0,0,0,0,0,0,0,0,0,0,1,0,0,0,0,0,0,0,0,0,0,0,0,3
0,0,0,0,0,0,0,0,0,0,0,0,0,0,0,0,0,0,1,0,0,0,0,0,0,0,0,0,0,0,0,3
0,0,0,0,0,0,0,1,1,1,0,0,0,0,0,0,0,0,1,0,0,0,0,0,0,0,0,0,0,0,0,3
0,0,0,0,0,0,0,0,0,1,0,0,0,0,0,0,0,0,1,0,0,0,0,0,0,0,0,0,0,0,0,3
0,0,0,0,0,0,0,1,1,1,0,0,0,0,0,0,0,0,1,0,0,0,0,0,0,0,0,0,0,0,0,3
0,0,0,0,0,0,0,1,0,0,0,0,0,0,0,0,0,0,1,0,0,0,0,0,0,0,0,0,0,0,0,3
0,0,0,0,0,0,0,1,1,1,0,0,0,0,0,0,0,0,14,0,0,0,0,0,0,0,0,0,0,0,0,3
0,0,0,0,0,0,0,0,8,4,9,0,0,0,0,0,0,6,1,1,12,2,14,14,2,2,0,0,0,0,0,3
0,0,0,0,0,0,0,0,3,1,5,0,0,0,0,0,0,3,1,1,5,0,0,0,0,0,0,0,0,0,0,3
0,0,0,0,0,0,0,0,3,1,5,0,0,0,0,0,0,3,1,1,5,0,0,0,0,0,0,0,0,0,0,3
0,0,0,0,0,0,0,0,3,1,5,0,0,0,0,0,0,3,1,1,5,0,0,0,0,0,0,0,0,0,0,3
0,0,0,0,0,0,0,0,3,1,5,0,0,0,0,0,0,3,1,1,5,0,0,0,0,0,0,0,0,0,0,3
0,0,0,0,0,8,4,4,8,1,5,0,0,0,0,0,0,3,1,1,5,0,0,0,0,0,0,0,0,0,0,3
0,0,0,0,0,3,1,1,1,1,5,0,0,0,0,0,0,3,1,1,5,0,0,0,0,0,0,0,0,0,99,3
0,0,0,0,0,3,1,1,1,1,5,0,0,0,0,0,0,3,1,1,5,0,0,0,0,0,0,0,0,0,1,1
0,0,0,0,0,3,1,1,1,1,5,0,0,0,0,0,0,3,1,1,5,0,0,0,0,0,0,0,0,0,1,1
101,0,0,0,0,3,1,1,1,1,5,0,0,0,0,0,0,3,1,1,5,20,20,20,20,20,20,20,20,20,1,1
4,4,4,4,4,10,1,1,1,1,7,4,4,4,4,4,4,10,1,1,1,1,1,1,1,1,1,1,1,1,1,1
1,1,1,1,1,1,1,1,1,1,1,1,1,1,1,1,1,1,1,1,1,1,1,1,1,1,1,1,1,1,1,1
1,1,1,1,1,1,1,1,1,1,1,1,1,1,1,1,1,1,1,1,1,1,1,1,1,1,1,1,1,1,1,1
,,,,,,,,,,,,,,,,,,,,,,,,,,,,,,,
,,,,,,,,,,,,,,,,,,,,,,,,,,,,,,,
,,,,,,,,,,,,,,,,,,,,,,,,,,,,,,,
,,,,,,,,,,,,,,,,,,,,,,,,,,,,,,,
,,,,,,,,,,,,,,,,,,,,,,,,,,,,,,,
,,,,,,,,,,,,,,,,,,,,,,,,,,,,,,,
,,,,,,,,,,,,,,,,,,,,,,,,,,,,,,,
,,,,,       ,,,,,,,,,,,,,,,,,,,,,,,,,,
